NO ./srcs/texture/north.xpm
SO ./srcs/texture/south.xpm
WE ./srcs/texture/west.xpm
EA ./srcs/texture/east.xpm

F 220,100,0
C 225,30,0

11111
11011
11011
10001
11111